################
#G#..#   # ##G.#
#.#.X. #.#    .#
#.###.# .# # #.#
#.    # .#    .#
#.### # .#    .#
#.#...# .   # .#
#.#...#X.#..#..#
#.##X###### ## #
#..........P#XG#
################
