#####.#..X.X..##.###G#X.#
.##.#P##.X...##.G...#.X.#
#.G.#.###.G##X.GG#.#G##.X
X.#.XX#.....G.......G.#.#
.G#..#X.#...###X##.#G..G#
###G...##G#X#.#..#PP#...#
#.##.#.X##.#.#..#.....###
.#.....##.#.X.G..#...#..#
G.#...#.P.G#X#.#..X..GGG.
#..##G.....#.#####.#GX##.
