################################################
#G#..#   # ##G.#################################
#.#... #.#    .#################################
#.###.# .# # #.................................#
#.    # .#    .########.............############
#.### # .#    .                              ###
#.#...# .   # .#################################
#.#...#..#..#..#################################
#.##X###### ## #################################
#..........P#XG#################################
################################################
