.###P#XX.P#G.#..####.X##.
#....G..X##.G##X#...P#G##
#####X..#G.#....#X#.XXX.#
#P.XXG..#..G...###..X..#.
#.G#..###X#.#.#..#.###...
..G#.##.#.#..#.....#.###.
#..#.###........#.#..#.#.
G....#.###X.G#.X.X.##.##.
#..###P.#.##.#.#...#.X##.
.#.#..#.#.G.##.#....G...#
