############################
#            ##            #
# #### ##### ## ##### #### #
#X#### ##### ## ##### ####X#
#..........................#
# #### ## ######## ## #### #
#      ##    ##    ##      #
###### ##### ## ##### ######
     # ##          ## #
     # ## ###  ### ## #
###### ## # GGGG # ## ######
..........# GGGG #.........#
###### ## # GGGG #.##.######
     # ## ########.##.#
     # ##    P   ..##.#
###### ## ######## ##.######
#            ##   .  .     #
# #### ##### ## ##### #### #
#X  ##    ........    ##  X#
### ## ## ######## ## ## ###
#      ##    ##    ##      #
# ########## ## ########## #
#      .................   #
############################
