##.##..#.###..#.##XP...X.
#...#...X#..G##X..G#...#.
G#...X#.X#...#..#..##.#.X
..###...#G...X#....##.#..
#..##G.GG.#.#X.#..X..##.#
.X#.#..##.#.#..##..#G....
...###..#.#..#.##.##PG#GG
.X.G..##..##...##XXX.####
#.G#..G#X##..#....#XX..##
##X#.G.#....#.GG#.#...##.
